# $Id$
#
# This file defines the `.Lb' macro argument.  Lines are composed of
# tab-delimited fields -- multiple tabs may delimit fields.  Comment
# lines begin with '#'; blank lines are also ok.
#
# These were last grok'd from NetBSD-4.0.1's mdoc.samples(7).

libarm		ARM Architecture Library (libarm, -larm)
libarm32	ARM32 Architecture Library (libarm32, -larm32)
libc		Standard C Library (libc, -lc)
libcdk		Curses Development Kit Library (libcdk, -lcdk)
libcompat	Compatibility Library (libcompat, -lcompat)
libcrypt	Crypt Library (libcrypt, -lcrypt)
libcurses	Curses Library (libcurses, -lcurses)
libedit		Command Line Editor Library (libedit, -ledit)
libevent	Event Notification Library (libevent, -levent)
libform		Curses Form Library (libform, -lform)
libi386		i386 Architecture Library (libi386, -li386)
libintl		Internationalized Message Handling Library (libintl, -lintl)
libipsec	IPsec Policy Control Library (libipsec, -lipsec)
libkvm		Kernel Data Access Library (libkvm, -lkvm)
libm		Math Library (libm, -lm)
libm68k		m68k Architecture Library (libm68k, -lm68k)
libmagic	Magic Number Recognition Library (libmagic, -lmagic)
libmenu		Curses Menu Library (libmenu, -lmenu)
libossaudio	OSS Audio Emulation Library (libossaudio, -lossaudio)
libpam		Pluggable Authentication Module Library (libpam, -lpam)
libpcap		Capture Library (libpcap, -lpcap)
libpci		PCI Bus Access Library (libpci, -lpci)
libpmc		Performance Counters Library (libpmc, -lpmc)
libposix	POSIX Compatibility Library (libposix, -lposix)
libpthread	POSIX Threads Library (libpthread, -lpthread)
libresolv	DNS Resolver Library (libresolv, -lresolv)
librt		POSIX Real-time Library (librt, -lrt)
libtermcap	Termcap Access Library (libtermcap, -ltermcap)
libusbhid	USB Human Interface Devices Library (libusbhid, -lusbhid)
libutil		System Utilities Library (libutil, -lutil)
libx86_64	x86_64 Architecture Library (libx86_64, -lx86_64)
libz		Compression Library (libz, -lz)
